好多小强出来玩哦，也太开心了吧？	yes
"很好~刚才受不了怪味,把豆浆的封口拆掉拿去流理台水槽倒,我才发现底下已经结块了,天气热归热也没这么夸张吧!!看来这豆浆真的有问题,感觉肚子怪怪的~是心理作用吗我去床上躺着等肚子发作好了...!!"	yes
都问过了说要一人一份，面都煮下去了才说妳两人只要吃一份！都问过了说要一人一杯，木瓜牛奶都打下去了才说要两人一杯！妳可以再嚣张机车一点呀！	yes
自以为是的人，以藐视别人当乐趣，没关系，你可以再过份一点，老娘我不接你的案子！	yes
"继手机不见,今天又发现皮夹也不见了..很好!!简直衰到一种极致..,最近运气真差..事情接二连三发生干脆从跳下去,是不是就可以终止衰事的产生!叹"	yes
很好...我在自找麻烦...用了外框字，结果累的是我自己！	yes
很好~~~已经一个追加不到了~~我就等著看到最后是不是全部都没有!噢噢!我的蕾丝~~我的花格纹~~	yes
很好~她不是在洗澡...刚刚打给我说：「对不起~我忘记了我在外面耶！」害我被蚊子小姐叮！	yes
很好这门课我扺定了!!!!浪费我时间!!!!	yes
可以再白目一点...	yes
很好翻到年年底的旧案到现在什么法催程序都没有进行一次还让我翻出三件真是有够扯的南东分行深水炸弹有够多	yes
挖洞给我跳~~~~~很好~~~~看谁比较狠~~~~	yes
今天还真是发生很多好事~去开会就被骂	yes
记者大人们的素质果然很好很强大...刚刚采访从灾区救出来的小孩子竟然问他爸爸在哪里...我就不信他们不知道国军是先救老弱妇孺	yes
机械式的可以再吵一点	yes
....陈水扁骨折原因是「坐姿不良」，马的你可以再虎烂一点没关系。	yes
"你可以再过分一点没关系,没看过这么不要脸的人."	yes
事情可以再复杂一点没关系.....反正做不出来就是做不出来....	yes
"很好!!锁了俺的餐厅,反正俺这星期也没空玩..."	yes
很好...看到桌上的一堆东西...我中午不用睡了...再次被气到快脑中风...	yes
"很好我的电脑整个不能动的坏了现在借用我弟的发噗,明天拿去给人家重灌,今天来锁卡玛值大只的回家后叫他写作业，却给我发脾气，说讨厌把拔永远不要看到把拔了！很好！"	yes
听奥竞赛场次可以再乱一点没关系	yes
我要咬人我要咬人啦月初可以再忙一点嘛..我看我今天没空跑厕所哩	yes
我娘家的电脑可以再慢一点...打完个字第一个字都还没出现	yes
事务所的网路可以再烂一点	yes
还真是谢谢你~~丢一颗炸弹给我ㄚ!!我要努力工作~~!!不要影响我~~!!谢谢!!	yes
很好，办公室的冷气又跳掉了，还好只剩不到半小时下班，不然我应该会抓狂吧！	yes
哀~真的可以再忙一点!!天呀	yes
脸上的痘痘可以再冒的夸张一点没关系......	yes
"很好!两周没上来多封讯息,值掉到.多'"	yes
一开年可以再衰一点~~~~~	yes
"今天早上开始狂咳嗽+全身无力,还是抓去医师那报到...真是太好了...又加一笔支气管炎...。"	yes
很好，很爱花钱，又败了一件衣服	yes
零下十一度...你可以再冷一点	yes
现在就.度..很好..我看等我要睡是几度..难怪这么热..	yes
很好..电脑其实是出问题+上某条可能坏轨..干!!..工程师跟我说中毒..中鸟啦!!声音明明就不一样..坑我钱..到底是要在搬去修还是..继续搞到它整个无法开机	yes
很好~~~要弄到点半...早知道就带来了...	yes
昨天晚上一个钟头醒来一次....很好.....	yes
"今天好怪,办公室旧版不能用,下载新版,从早上点下载到下午点半,微软可以再软一点"	yes
安全监控三雄奇偶升泰都涨就我买的那家跌运气也太好了吧	yes
"很好!睡一顿后起来喝奶,现阶段花名开始高亢地做发声练习"	yes
被香水燻到流眼泪...'...可以再重一点	yes
很好在打喷嚏了我就知道淋一早上的雨会感冒'	yes
雨可以再下大一点阿	yes
很好~熊熊转头已经快点了时间过得还真快呀!	yes
很好....主管都没来上班阿...	yes
真是太帅了太久没发言归了	yes
很好很好...雨用倒了....	yes
"光芒,红雀你们可以再贫打一点!!!"	yes
学妹妳可以再白目一点!!!四堂课都过了快一半了才进教室，明明就有很多空位，连我第一牌的座位也要抢，硬要抢我的电脑，明明我有在用电脑，都叫她找看看有没有其他座位，屁股动都不动，随便往后面就盯着我的电脑说没有位子，是我不想计较想说给她做，拿着我的东西换了位子!!	yes
"很好....仓管什么都不懂,生管很忙...所以都由我来做!!"	yes
很好...儿子滚了一个晚上..我就酱睁着眼看日出!!	yes
很好...连左大腿也开始酸了..	yes
"真是太好了!水压不足水好小,无法洗澡~'"	yes
"很好,我现在还在公司"	yes
远传门市小姐你可以再白目一点	yes
很好!!!....右边的耳环不见了...	yes
太好了明天要去开会........	yes
很好很好身边一堆人都跑去看变形金钢了...我也好想好想好想好想好想去看'	yes
楼上的肖年ㄟ~~~你的音响还可以再夸张一点齁.....	yes
很好~庄家连一拉一~今天还是不顺中	yes
"很好很好....进场四小时才帮我换大位子,光是我前面的大位子都空一个多小时了,亏我还提醒了柜台两次....短期内如果再储值我就是小狗!"	yes
妳可以再自私一点...妳跌倒就全身残废好几个月都要人服侍妳！我跌倒手都肿起来了，有煮饭给你们一家吃就很了不起了！你还要我去整理厨柜...掯！别人家的小孩死不完也不是这样的啊！	yes
被辣到眼泪鼻涕直流真是太爽快了~	yes
"出现了讨人厌的问题，在。还好我们一排三个人代表了演化史，分别用,,，浏览器版本可以再多一点"	yes
很好!!非常好!!当当手脚冰冷~估计晚上要发烧了	yes
我阿爸竟然问我要不要开冷气....很好~我去咳嗽给他看~~	yes
很好，公司笔电硬碟开始有鬼叫的迹象，这不就是坏轨的前兆吗，拎娘哩。	yes
太好了我找不到昨天玩的开心水族箱了	yes
"很好,我中奖了!!!我踩到我家娃娃的狗大便"	yes
噗浪你可以再继续一点没关系啦!	yes
实在没办法接受这种处理事情的态度。可以再给我摆烂一点	yes
很好干部训练！！！	yes
很好~追完从前一天半夜到今天下午的噗了~再来追新长出来的噗	yes
....靠北市政腐你可以再烂一点，听障选手当你的交通白老鼠，爽了吗	yes
中华电信真的可以再烂一点阿	yes
很好!!忙了几天我的掉到只剩几了....啃!	yes
写作程度可以再给我差一点阿写作到底要怎么自我进步阿真的只能去补习吗...目标是至少雅思分	yes
公司英文考试可以再机车一点.........不想给人家领钱也不用这样搞...题目一次比一次机车.....	yes
撒塔尼欧都拜~你可以再欧都拜一点阿	yes
不用台风我也看不到球赛了吧，可以再不争气一点啊	yes
真是要气死我了！你可以再心机一点啊!!	yes
..又有一个立法委员被法院判定当选无效!!第四个囉~~不过，他们好像是依照马英九指示行事啊!!马英九你可以再口吃一点......真的很蠢!!还当选之前就要开始~~幕僚们快给他一罐白马马力夯吧!	yes
"上课时中天记者突然打来要采访老师,既不事先约来了又一直催我们赶快烤个蛋糕给她....我们在上证照班耶...没看到在打面包的面团吗打蛋白时手都没洗就嫌无聊抢着要打...已经够发了还不听劝阻不肯停,走了也不说声谢谢..中第四台记者可以再没品一点"	yes
"有些真是脑残到爆炸,可以再没头没脑一点!"	yes
"可以再白目一点,清晨五点打来问我你睡了吗扰人清梦"	yes
恶心，驱长说礼物退回人家会伤心后，又改口收的礼物已经送给弱势！（你可以再ㄍㄟˋ一点）	yes
中天新闻可以再鬼混一点连帮你骂人的噗浪机器人都可以做一则新闻...怎么可以有这么无脑的新闻	yes
维修工程师你可以再混一点啊...风扇上面已经贴了注意事项，还可以给我装错方向......	yes
约早上九点的会，到现在还没开始！可以再夸张一点!	yes
公司的冷气可以再冷一点嘛!是把我们都当御饭团坚持度吗	yes
节耶~~吃个饭不过分吧~~拜托~~~~~~~香川他讲话可以再贱一点阿!!看新闻真的只会有满肚子辛酸和脏话而已!!	yes
...山寨版猫熊!!你们这些无德业者对待狗狗可以再夭寿一点	yes
救命啊~~~这个可以再冷一点!!!狂喝温水都没用!!!新闻棚这边的空调跟二棚是相通的，只要二棚正在，就不可能关冷气。夏天的时候有西晒，可以让这房间很温暖。现在天气一不好，就不行了...冷死了!'	yes
可以再恶心一点!!!...	yes
这雨还可以再大一点，得湿身上班了~~'	yes
这个总统可以再白目一点，明年月欧盟免签是吧!再大声一点ㄚ	yes
死管理员你可以在把住户的问题讲得再事不关己一点没关系~这是第二次了，别惹火我~我好歹也算是个写报告能手什么不会写几篇报告书应该还不是难事之前害我车被市府拖，你可以再让我等久一点看马桶什么时候要来修~	yes
第一次跟强迫症很严重的一起吃饭，但是非常开心不过点妈妳可以再笑大声一点真的！！	yes
你可以再不够意思一点祝你以后肚子越来越大~	yes
干！可以再过份一点啊之前没弄清楚自己的预算乱聘人然后又随便裁，要我签的请款单自创格式不通过竟然只发了一封叫我重签，一通电话也不打；等到我一个多月后打开那个信箱才发现，竟然有脸跟我说都连络不上我？我说的就是你们！阳明大学生医资讯所！	yes
扑浪你可以再帅一点.......	yes
真的很受不了！！到底是谁总是把马桶弄得脏兮兮？干净的马桶座垫妳不想碰到...却要我们其他人用满是尿渍的？可以再没有品一点...	yes
邮局的美国臭老伯..服务态度可以再差一点!自以为是白人就很了不起那样	yes
你可以再宠女儿一点！我不知道还伺候小三生整理书包起床穿衣会有甚么后遗症，不过，我想可以不用期待这个小孩往后会有甚么成就了！这跟....大学宿舍没装空调新生家长当众哭诉的家长有甚么两样？！	yes
突然想到，最近她超早下班的，连昨天可以八点就给偶下班约会去，真的可以再夸张一点!	yes
"刚刚看新闻真的很扯,淹水的地区都已经没电了,他们是有电可以看的到电视新闻吗!他们要怎么打电话通报灾情呢记者跟主播可以再天真一点没关系!"	yes
你可以再夸张一点办公室热的要死你不要空调一打立刻穿外套到底是不是男人这么虚	yes
秘书小姐你可以再夸张再懒一点!	yes
非死不可的开心农场可以再给我烂一点	yes
可以再白目一点	yes
"刚刚打电话给尪,跟他说今天七夕吔~他说喔~七夕可以吃吗我的尪,没关系你可以再不浪漫一点!!我要跟儿子出去约会~"	yes
"你可以再挑衅一点...是把我当小偷吗!不跟你发脾气只是不想跟你撕破脸...如果你嫌我还为你做不够,那麻烦你以后都自己来吧!!我很乐意!!"	yes
你用力的翻我用力的...你想要扁我吗卖高丽鼻比!（予想：你可以再欠扁一点！）	yes
"....扯？小兵投书：救灾等不到长官下令不仅天灾,更素人祸三军统帅马英九,你可以再无能一点!冷水坑当事人刘兆玄,你可以再自我感觉良好一点!"	yes
今天的电脑'可以再慢一点没关系	yes
雨水打滑我在家具店门口警卫面前大滑一跤，脚踝撞到阶梯直角处肿得跟小笼包一样...可以再糗一点没关系...	yes
非常好!!楼上施工中~可以再吵一点!!	yes
面对惨不忍睹的灾情....马政府可以再白目一点！！	yes
...你可以再抽象一点没有关系…	yes
轰胎~可以再强一点吗.....	yes
时间..你可以再龟速一点!!	yes
妳做事可以再没效率一点	yes
可以再烦人一点	yes
"冏噗维持了一周的迷濛眼+头晕..,再加上跟在那边研究是不是电脑萤幕问题之后,我终于找到主因了..就是{我把隐形眼镜左右戴相反了}..很好!!!!我可以再笨一点再笨一点阿..."	yes
遭埋女童总统妳可以闭气两分钟不简单!..你可以再白目一点~~	yes
"昨天去看中医,晚上九点出发点才到家!可以再等久一点哪而且走出诊所之前才发现其实用拿药的就可以了"	yes
现在进办公室都很内伤~油条硕士!!你可以再过分一点~~	yes
值连降两次是怎样ㄚ管理员你可以再过分一点!	yes
"可以再不尊重我一点...晚上点被通知下礼拜一回早班....,还不是直接跟我本人说....超想骂脏话"	yes
雨可以再下大一点没关系!!	yes
妈阿~~雨可以再下大一点!!!	yes
乐的网站~~真的可以再慢一点~~我非常的有耐心~~	yes
今天的头毛可以再毛一点!!!!!!!!	yes
厚...台中天气真的可以再热一点...	yes
我想...我快失业了....老板你可以再讨厌一点!!	yes
你们可以再烂一点..又被逆转了	yes
打成可以再天才一点呀保险业务员	yes
可以再蠢一点!刚刚倒水开错开到热水去~~~烫到手	yes
暑假作业可以再多一点.....每天都累的要命	yes
自己可以再笨一点没关系!!!领个钱忘记拿卡...不知是不是会被机器吃掉	yes
印刷物又出问题~公司东西可以再赶一点没关系!!!!都没时间检查的下场~下次就是直接自己印完做出来有问题你们自己去收尾!!我去校对然后把自己忙死是怎样!好烦阿!!!!!!!!!!!	yes
！你可以再爱断我的一点！	yes
农场~~可以再傻一点~~上一秒才在灌溉!下一秒跟我说太久没更新网页什ㄇ鬼阿!!傻傻的	yes
同部门的不能知道密码，可以跟别公司的人说密码，马的....可以再机车一点！	yes
"连续天加班,饿著肚子回家今天晚到计程车费要加成,「百商」可以再夸张一点,妈的"	yes
"可以再夸张一点!你们这些人........,,+,."	yes
"终于搞清楚了,现在是.是吧!可以再抢多一点啦!哼哼!"	yes
今天可以再忙一点....'	yes
人生最后的暑假可以再精彩一点	yes
"发电影票的人,你态度可以再差一点!"	yes
种花可以再慢一点没关系	yes
为什么大家很爱问我成绩都研究所了还耍一些花招得高分不必要吧然后同组的分数可以不一样不知道这些老师是干什么吃的你可以再偏袒一点没关系阿不好意思我爆冲了	yes
工作可以再多一点。	yes
做人可以再不要脸一点	yes
汇丰银行，你们可以再跩一点...	yes
可以再贱一点...连剪刀也要少我二块...而且以前还没卖...是要来拼吗!!...	yes
明天要去实习耶好紧张最近可以再忙一点没有关系阿阿阿阿阿阿~~呐喊	yes
竟然作弊，你可以再机车一点......	yes
靠咧整个可以再莫名奇妙一点...小玫也是蕯克奇	yes
东野圭吾！你的白夜行可以再灰色一点没关系...	yes
楼上的死小孩，你关门可以再关大声一点，吓到晴晴睡觉了啦！	yes
公司网路可以再烂一点	yes
法官你可以再扯一点~直接拿报纸当证据来质询被告？我不晓得记者什么时候多了个「特侦组调查员」了身份了？	yes
你可以再给我烂一点~小心我叫大哥大把你弄掉	yes
"公司男同事可以再懒一点没关系,连昨晚买的新手机要放价目表进去也要来找我用!!!吵著说昨天才买的手机,不会用...真的让我抓狂的狂骂不是不会,只是懒!!竟然还跟我说对电器就是不会嘛!最好是不会啦!我只花了五分钟就搞懂你的新手机了!而且还是三星牌的"	yes
"我看不清,是谁蒙蔽了我的双眼!才发现...原来......我的眼镜可以再脏一点没关系..."	yes
小莫，你可以再超过一点!!!话说，一直听到玻璃破掉，东西碰撞的声音，还真是有恐怖!!	yes
"烂电脑,你可以再慢一点,等我受不了就把你砸了.."	yes
原来不是不见还真的是没带啊....我可以再脑残一点啊	yes
可以再机车一点...	yes
我这边ㄉ天气可以再好一点ㄚ...吼~~~~~大太阳ㄝ~~~各位能想像吗!!...	yes
你!!!....可以再讨厌一点，老是站在别人后面看别人的萤幕...烂人!!..就不想和你讲话了，还一直问东问西...很烦人耶!!	yes
台哥大司机~车可以再开快一点。我真的没那么赶时间…	yes
早安!可以再热一点没关系。前阵子新闻说有台风就有地震，看来是真的啊!咖啡有台风就有震乱亨	yes
靠么勒!!中华信的客户可以再狠一点!!!今天才要开始做的案子要号上线...不给延期还叫设计师都别睡了!!!	yes
亚太的收讯可以再烂一点!!!!!!!!!!!!!!直接断讯是怎么一回事!火大	yes
可以再更难一点没关系	yes
所以注定我这辈子是做不了商人妈蛋	no
无论是心情多么低沉的夜晚，天光大亮后都是崭新的开始。	no
帽子怎么就变绿色幸好只是试一下	no
不想当个好人，好人的背后有多少的心酸害怕喝醉酒的人，害怕他们做出无法挽回的事情是真的会醉么？还是找个机会发泄出平时不敢说的话，不敢做的事呢，这样失控的人，真的很可怕2016.10.1晚上八点二十八分	no
一种爱是你可以为她去死；还有一种爱是得为你爱的人好好活着。	no
考了两次普通话，每次都离目标差一点点，就一点点！！要被气死了！！	no
尼玛吓死我了，人家剪个头发回来跟劳改犯一样短的可怕，后面什么鬼[黑线][黑线][黑线][白眼][白眼]	no
活在阴影里这么久，还不是出来的时候	no
小紧张~不过美美羊和圆圆媛要去看我表演，好开森啊！	no
感觉自己被一杯红茶玛奇朵给收买了不开心	no
你以为你是谁啊。就你这样的，，，，我也是醉了！	no
是安徽省规模较大的科技中介机构之一。	no
本标准由第七分会“书刊号标准化工作组负责起草。	no
这样折磨我真的好吗？为什么我背的题一道都不考，伐开心	no
一个人真无聊，美食都没味了，你要在就好了…唉………	no
早上和妈妈生气，居然说，找个新妈妈	no
把孩子的涂鸦做成长毛绒玩具！一切来自一个真实的灵感：一位母亲把她四岁儿子的涂鸦做成长毛绒玩具。(via风过山)	no
这个村的年轻人大多数都出外打工。	no
#linther说#以前，他从来不对我说晚安，就算每次我发了晚安，他只会回“拜”。今天，他主动说了“晚安”，我心里一惊，又觉得是不是自己想多了。	no
除此之外比较让我恐惧的就是，自己的智商是有限的，有的东西我可能一辈子都理解不了，但是却有人能够轻易的理解。就像看着自己怎么伸手都够不着的果实被别人轻易的摘去了一样。而且那里明明还有很多果实，我能看得到但是一辈子都够不着。想想真是让人害怕啊。不甘心也没有用，为什么我不是天才呢。	no
手机买了12天就降了300，摩托你的手机情怀呢？	no
形成的土壤为潮沙泥和潮沙泥田。	no
卧槽！！！！！！禽兽！！！！！！！！	no
为什么老师看见我的桌面会问我：“你平时是不是打游戏？”	no
棉花一枝独秀？难道看不见服装业的形势？	no
前身为始建于1892年的“宽仁医院。	no
最近追三国演义，曹操要刺杀董卓，关键时刻吕布突然进来，曹操转势跪献宝刀，吓一头脑袋汗，这个演技我给后来刺杀收留他的吕伯奢一家看的心惊	no
【女生健康睡眠】女生一旦晚睡早起，生活作息就会严重违背生物钟，易成为慢性失眠。有睡眠问题的女生是男生的1.5倍，有慢性失眠问题的女生是男生的1.3倍。睡不好的女生常有脑中风心血管疾病的患病风险。女生每天最好睡足8小时，不要少于6小时。中午最好休息半小时到1小时。晚上最好10时左右睡觉。	no
从听《callmemabye》到现在，今天第一次看歌曲的MV，拍的很唯美，女主很小清新，男主很阳光很帅气，but，最后的结局却是：那么迷人好看的男主，他callmemabye的对象竟然是乐队的吉他手，他喜欢的是男的。	no
过了太久安逸的生活了，被最近一系列的国际大事惊呆了，这是什么节奏	no
5月22日上午9：00——10：30，申报高中、中职、实习指导教师资格人员教育教学能力测试笔试；	no
想自己装个软件，咋这难呢？？想骂人	no
加州最有名的意面，披萨，居然也要排队，蒜香虾球面，宫爆虾球面，好吃	no
真是火大做了一遍乱码白做重做又乱码破系统能不能不闹	no
似乎又被禁言了渣浪你想怎样，我的vip是白开的吗？	no
心里好烦好烦好烦好烦你们不熟你妹啊那你上课的干嘛跟她讲话卧槽靠靠靠！烦死了还笑那么开心我去你大爷你怎么跟她不熟了我靠	no
我没有你们那种与生俱来的自信…也或许曾经有过…?	no
到海关办了退运，花了286，肉疼	no
看完恐怖片才意思到自己是一个人睡旅馆，楼道隔音不好能听到脚步声，楼下还有那种服务，害怕到没有困意	no
谢谢honey们帮我庆祝生日！！！谢谢你们的祝福，谢谢身边的所有人！爱你们	no
一到下雨天就莫名的惆怆，下一秒情绪就完全奔溃，闭着眼睛忍不住的流眼泪，这种情绪陪伴自己已经有一年半了。我想哪种心酸，委屈，无力辩解，和深深的遗憾只有这淅淅沥沥的雨声知道	no
熬到了天亮，好神奇一点睡意都没有	no
终于………以前都是在上面的��柔板跟催眠曲似的，豆说他弹的速度比她数钱还快	no
感觉很不好，需要音乐平复我躁动的内心！���	no
"2011.11.24,11:58分，《垫底辣妹》里最后因为一向被自己忽视小看的女儿考试了梦想中的大学，爸爸背起女儿....我竟然想大喊一声：你如果此刻冲到我面前来找我我就原谅你.....呵呵..."	no
全场比赛结束，阿森纳3:0战胜萨格纳布迪纳摩，桑切斯闪耀全场，接下来欧冠最后一场生死战，让我们去希腊赢两球或者3:2的比分	no
一觉醒来你发现你梦到的人身边不是你你的未来也不会有他心里的一阵失落感和难受就会升起	no
而起关键是在燃油的精确配置和废气的后置处理，各多的电子新科技将运用到新一带柴油机上。	no
纯君也在玩touken的节奏？	no
只想说，有些人完全不懂什么叫人情味，既然你不懂人情味，也枉费做一个人，那么我也就不用把你当人看，尼玛，心塞，是很塞	no
1986年在遗传病研究中，张乃赓新发现了6种8例遗传病，获黑龙江省计划生育委员会遗传病研究一等奖，并获黑龙江省科技进步三等奖。	no
为啥子都喜欢赶在中午饭点过来啊啊啊，你们午休能不能也让我们歇会	no
字迹潦草却不失内涵，宿舍不拔插线板写的检讨大二的我们身不由己呀，真心不知道怎么写	no
更年期的女boss真的让人受不了，烦躁	no
今天晚上给别人写推优的什么东西，还有选修课，明天晚上要交的物理实验数据还没处理，周六要考综合交通，没复习，还正好是物理演示实验的那天，还有一个月考四级，没怎么背英语，听课听不进去，跑步停了半个月了，锻炼虽然一直在做着，但是晚上开始吃了，负能量爆棚，真糟糕	no
第二十一条??严禁弃婴、溺婴、非法收养子女。	no
空闲时间太多，就会胡思乱想，以至于唤醒了心中的彷徨。	no
老舍《黑白李》：“黑李是我的好友，因为常到他家去，所以对白李的事儿我也略知一二。	no
阳气就是阳清之气，阴阳二气混杂从而化育了万物。	no
永远在变的计划，你什么时候能让我追上你！！！！	no
吃个宵夜而已嘛你就开始痛痛痛了.6点还要起床.我只想安安静静睡个觉.乖!不要折磨我了呵.	no
听得太多命中注定，看来得准备自己一个人好好过了……一切是好是坏我都欣然面对！	no
这支DirtySouth名团组建于1991年，全部团员来自佐治亚州首府亚特兰大市，成员分别为Cee-Lo、Khujo、T-Mo和BigGipp等四人。	no
梦见某国发现某病毒强化人体，收集了一批志愿者和选中的军人来试验，不行的会被淘汰。病毒感染的人对宿主会天然有好感，但是满足宿主条件的很少，好容易集齐了所有条件找到了一个人，但要很残酷的全部打碎重组，然后经过强化宿主和被病毒感染的人的关系就可以组建一支绝对服从的强大军队。	no
换季降温也想美美的？一条围巾就足够啦！小法为大家普及几种冬天最常用的厚围巾的系法，赶快叫着小伙伴，一起get√起来吧！	no
我竟然才知道我有一个富二代加官二代加红二代的朋友	no
画个圈圈诅咒你！（臭老头）脏鬼！	no
一早起来陪伴自己3年的那根笔居然不见了真心是找不到了	no
全村辖1个村民小组，其中从事第一产业人数110人。	no
一首摇篮曲搞定一个吃货，那也是神了	no
小区取缔垃圾桶，以后没有大爷来每天收拾两次垃圾桶了，我好怀念收垃圾的大爷，有大爷的日子垃圾想扔就扔	no
两个班的差别怎么辣么大一天给你们上课焦死人	no
@新浪微博你个碧池，设置的什么破功能，不是说好的仅自己可见吗？tellmewhy？你个碧池！	no
天阴下雨，浑身酸疼的赶脚，不喜欢	no
开会开到现在，饿成�了，我想妈妈	no
总是忙忙叨叨到现在，但是泡过脚之后睡觉真的很舒服。昨天晚上梦见二肥，我很想你，陪我一起长大的你，在那边要好好的。	no
我也不太懂为啥要保持最坏的打算，担惊受怕过三年，并且担忧越来越强烈。希望结果出现的时候，不会影响正常的生活。	no
不是抱怨。而是根本想去拿着所有东西摔他脸上告诉他你妈逼啊！卧槽！	no
今天又拔出这么多白发，我还年轻离我远点	no
每一个管理者都可以对照拉伯福所说的这十种错误，举一反三，验照一下自己是不是犯过类似的错误。	no
现在的警察都是这样办事的么？！	no
看了多篇报道，有植入广告嫌疑，西方人能干得出来？	no
胖了胖了胖了，怎么才可以不受美食的诱惑。真的胖了	no
改变命运的时候来了，可惜不够分，有点失落	no
今天是宝小姐第一次，参加学校举行的“万圣节”…看来玩的好开心	no
真的很后悔以前的微博都删了好多东西都找不回来仅剩一些残余的记忆	no
[婴儿]#Day98#第一次摔下床，现在还心有余悸。并没有一直哭，哄一会吃完奶就睡着了。看着满脸蚊子包熟睡的你，真是后悔，心疼！这是第一次一定也是最后一次。	no
"我的神哦,还好我不但不泡脚，而且从来不洗脚赶紧泡会压压惊"	no
今天是个倒霉的日子…………………	no
如果把信息发给接受不到的对方，可以很直接，不用这么纠结	no
外国学者称它为“中国17世纪的工艺百科全书。	no
月华寒子夜，更漏待天明。梦中忽觉醒，回寰一息中。	no
典型的外在报酬为经济薪酬，即货币薪酬。	no
做这道菜的心里过程：在菜场看的时候，它们一个个喷着水撒欢，买回家清洗的时候它们都害怕地紧闭着盔甲，由于泥太多，我用力清洗时发现把一个壳弄碎了，觉得它们好可怜~炒的时候很纠结，把它们一个个炒死了~他们有没有神经系统啊？但熟的时候闻到香味我就忘了它们生前的所有，人类好可怕	no
看了几日的视频教程终于狠下心安静的去织了感觉还挺不错的妈妈老公都说还不错心里挺开心	no
做过的选择极少给你回过头更改的机会，又没勇气抛下所有另辟一蹊径，只得努力奋斗，使最初的选择变成正确。	no
如果哪位有幸考中了第一名状元，不仅能得到高官厚禄，还可以名扬天下。	no
1906年转入镇平县立第一高等小学堂，次年，考入县立师范传习所。	no
特么即participation后，reflectivewriting成为了我最恶心的体裁1000的反思花了我四天天天检讨才憋完……	no
万历十七年受封世子，天启元年，袭封周王。	no
自己买的东西冒着雨也要拿回来，要走那么远内心是崩溃的	no
我就想问一下@杭州市民卡你们是怎么做到过去一周不管什么时候打你们客服电话都是“服务代表正忙”的忙音。	no
刚刚上床，肩膀ba了一声，感觉整个左肩都不好了疼	no
从以前到现在都是这样，会恐惧将来发生的事，会恐惧将来对那个时间的否定。会害怕自己的麻木。即使回过头去想以前的事，并没有什么。但是现在当前的时间点上，让我去想将来会冷漠的看这样的自己，让我害怕不已。	no
想吃什么的时候正好能吃到这一定是世界上最幸福的事情之一	no
在他们喜闻乐见的环境中引导他们！鼓舞他们向那些真善美学习、这样我们的国家！我们的民族，我们这一代的大学生才是有希望的！	no
看完后，怎么会有这么大胆女孩，恐怖[惊恐]！这个个社会，真的什么人都有。不能随便发定位这些了！好恐怖！	no
网又没了，又在挂流量，要崩溃。	no
妈蛋的TB坑爹的无良商家！挣黑心钱也不怕遭雷劈！怎么说都不理人！给我气不行了！	no
就这样，我三个月来的纠结和痛苦就这么过去了。回头看的时候，依然还是心有余悸。一路艰辛，终得其所，虽不是如愿以偿，但已尽力，自己努力无愧于心，但深得教训。此事为今后之参照，愿再接再厉！	no
耳边听着“不要告别”，又想起了五六月的武汉，空气是潮湿的，也是人心惶惶的，太多人要离开，要告别，我也在惴惴不安和不舍中离开，现在想来在武汉的两年是最自由的，又想到了璐璐和黑学霸……	no
说好的起来看书，一觉过午。饥肠辘辘煮面，发现没盐了，等了半天面还没熟，原来跳闸了，重新来过等，还没熟，奥，原来插头掉了…我顶！老子他妈不吃了	no
安静的可怕，这个时候应该看个恐怖片[惊恐]	no
又停电fuck有多少事都我不能干了	no
事实证明，十一过后我就拆蚊帐是多么的错误！这几天没一天睡好的，平均每晚都要三四个蚊子，谁家像我们这么多啊？家里会不会有蚊子窝？我认输了，明天重新把蚊帐装上今晚这个我还没找到，关灯就嗡嗡，抓狂死了	no
你看到是世界都是被包装过的，就像纳尼亚传奇里白皇后变出热奶茶和巧克力，最后都化作一团冰凉的白雪。大家说着言不由衷的话，口是心非的说他们爱你，支持你。却又在心里偷偷地埋怨你。就是这样的吧。	no
每次回忆起来都是满满的温暖和感动	no
@苑洛fover婧祺说：“你是弯的！”我没反应过来：“啊？”然后顺着她指得方向一看，原来是月亮	no
10月才刚刚开始，已经给2017年预约了三件大事。在日本似乎习惯了一切提前安排，似乎计划让我们的生活丰富多彩并井井有条，但有时也会有些小迟疑想想它是不是真的好，拖拉时间向前的同时，不免也有种惧怕被时间碾轧的小恐惧。	no
快速化解愤怒的是与愤怒不相干的工作。工作，没有感情色彩，客观存在，可以集中注意力，也可以消耗体力……	no
一回到寝室就开始做ppt!我真是要崩溃了！脑袋里的想法那么好，为什么就是做不出来呢！先是一个技术问题，搞了三四个小时解决后，又找不到合适的图！我真的心好累！痘痘都长一脸了明天我就是不吃不喝不睡也要把ppt做出来！再求有没有人有眼睛鼻子嘴巴耳朵头发特征明显的卡通图�	no
12月乌鲁木齐市环保局和市教育局命名乌鲁木齐市第二十三中学为“市级绿色学校。	no
圆通快递，暴力运送！都成这样了，竟然说没有当面验收，完全在推脱责任！	no
《小萝莉的猴神大叔》国界之门打开那一刻什么宗教国家矛盾统统靠边站感情不分国界特别感人的电影好看就是了�	no
物流显示已经签收。可我没有收到阿。去小区物管也没看到。打电话没人接。几个意思。	no
人间土味好可怕恐怖看到这种东西就不想结婚但是根据什么垃圾配什么垃圾桶的原则我觉得我也不可能和这种人结婚但是我还是很震撼我要去看钱困困微博缓解一下	no
白天鹅(海盗旗)出击…下一次不会把伊斯坎德尔甚至白杨搞出来吧…	no
我大概1月9、10号左右回家，越来越近了。老公，好爱你啊	no
1公司位置??公司logo??单开纱窗主要产品：I、隐形纱窗、纱门。	no
现在出去都没脸跟别人说我是火箭球迷了！！！。。。�	no
14、洛那类风湿性关节炎、骨性关节炎、腰痛、肩周炎、颈肩腕综合症，以及手术后、外伤后及拔牙后的镇痛消炎，急性上呼吸道炎症的解热镇痛。	no
  商业票据出票人（DRAWER)出票人是签发票据并将票据交付给他人的人。	no
广东人热冬伤不起，求2000块买台空调	no
今晚只能在厕所度过了？闹肚子闹肚子闹肚子大晚上的	no
这一定是exo专供烤肉店，一次两次广告都不用了，�一点都不羡慕	no
裴娜从孙培处得知自己的体检结果里居然有孕检一项，大惊，认定是丑女们故意要出她的丑，假装要跟吴庸坦白，从马莎莎手里骗回了体检单。	no
饭上金菠萝后的第一个生日开心！碎觉啦！鸟宝宝们晚安	no
昨晚上那只很大的蜘蛛吓坏我了，一时手软没打着不知藏到那去了，现在睡觉都有阴影了，床和边边都翻了几遍，应该走了吧	no
柳如烟只好找些助孕的偏方来吃，果然象怀上了。	no
昨晚和老妈生气，今早接到学生电话说错过了考试时间一直担心中午赶车摔倒水坑里脚崴了我的玫瑰金屏幕也碎了我想知道我还能承受多少。	no
看得多了，心也大了，好的不珍惜，差的舍不得放弃，矛盾纠结，感觉什么也感动不了我，怎么会变得那么狠心�对自己好失望，再也回不到原来的我了	no
初见台北～国父纪念馆、台北101、诚品书店的一天～结果，就在刚刚半小时前，就地震了！可吓死姐了…躺在酒店床上好好的，顿时感觉怎么晃的那么厉害！长那么大第一次感受这么可怕的晃动，可怕！谁能报道出台湾的地震问题…我看看这是几级地震?|台湾	no
晒晒儿子照片，第一次发，多多关照	no
减肥，，，减肥，？(不能再吃了，死胖子)	no
[喵喵][喵喵][喵喵]最后一个最可怕[泪]吓哭了太吓人了	no
【旅途日志】人在旅途，真理往往是简捷明了的，只是由于心灵受到尘埃的蒙蔽，使得简单的道理变得复杂起来，一旦想通了，明白了，人生之旅就不会左顾右盼、茫然不知所措了。屈原在《离骚》中感叹到：路漫漫其修远兮，吾将上下而求索。世界太大，生命太短，如果不导演好自己，怎能悟透人生的意义?	no
晚上八点睡着，感觉睡了一个世纪，她妈的一睁眼才12点，睡不着了	no
我去～骗子的手段太高明了，你跟我谈法律，你还不知道我是干嘛的吧，小心点，我警告你，别惹火了我(大家小心点，千万别上当)	no
工作太认真了竟然忘了吃饭时间，现在肚子咕咕叫，只能出来觅食了	no
最近净遇到点sb真是日了tm了	no
正所谓“十指痛归心”，谁能感受这N+1只草泥马在奔腾的感觉？	no
土都吃不起的少女只想要1500块钱把花呗还上-.-	no
老公说只要我每天过的开心快乐就好，他养我，听了心里好感动，当他把工资卡给我的时候说，宝贝你想买什么就买，我的心里美美哒	no
憋屈的事情，劳心劳力的你以为我很愿意？	no
复制另一个人，复制所有的性格却没有情感和记忆，轻蔑地看着过去的自己，还有我	no
人若看清和明白自己的处境，就只能承担的，即使心里有一种畏惧，对着萧瑟的，对黑暗与幽闭的恐惧，也要承担着它，回到自己的使命中。有骨骼的哀伤，那等同于一种自我克制。	no
它们分泌一种液体给蚁吃，而蚁餵养它们作为回报。	no
弘光时监生，隆武帝赐姓朱、号“国姓爷。	no
各部门职能明确，在相对独立基础上通力合作，以促进本协会健康向上发展，统一管理协会事务，受会员监督。	no
你真正喜欢想要的，没有一样，是可以轻易得到的。这就是努力的理由。	no
烦，今天路上怎么这么堵，动都不动！！！	no
HCG即人绒毛膜促性腺激素，是受孕妇女妊娠期由胎盘产生的一种糖蛋白，可通过肾小球从尿液中排出。	no
最霉的一天！换班换班！有本事你去买辆车啊！每次我跑腿！还是绕远路！每次一换班心情就不爽！弄的好像我理所当然一样！	no
感觉很惶恐害怕自己控制不住想从窗口跳下去无牵无挂一了百了	no
大半夜的为什么要看家乡小吃...现在又饿又想家	no
为什么出门不带钥匙为什么出门不带钥匙为什么出门不带钥匙	no
话说原来楼下装修不是入住而是要出售	no
这是同一只脚么，怎么变化这么大？	no
我靠我该怎么做才能解气贱人年年有今年特别多真的是够了	no
医院现有在职职工1300人，其中医技人员占80%，高级专业技术人员110多人，中级专业技术人员近500人。	no
今天老妈回家去参加她老同学的婚礼回来跟我说看看人家都结婚了你还天天赖在家我说这催婚吗不急不急妈该找了呀我说我怎么找啊大街上随便抓一个能行吗妈能抓就抓吧(亲妈呀你好开明)妈呀这个急不得要不然你问问你女婿杨洋	no
起床真的是无比艰难的一件事本来，考翻译也没什么好复习的，可是这次偏偏要考中外翻译史中的人物。整本书那么多人物，其实我也不知道会考哪三个，但是我真的是不会甘心放弃掉那30分呢继续背书去了，说不定就押到了呢…	no
刚才写了篇长篇日志，内容非常精彩，点发送的时候，麻痹手欠了...点错了...没啦就。	no
你要走就走得再远一点吧。我不怕你从别人那里获得新的快乐了，可是我怕你再回一回头。	no
负能量爆棚了感觉要炸了..怎么他妈的还在原地踏步	no
大概是我妈get的拍照新技能。我还以为是我从162奔向了165	no
陌陌号被禁言，是有人举报我了么，谁能告诉我	no
骗子的技俩，你信一成你都会倾家荡产这是绝对真实的实例发生在我身上有一天有一个自称是外国的将军加了我有一天他说他儿子在非洲旅行说他儿子没有零用钱了他那边也没法去银行会账给他儿子叫我寄钱给他儿子请大家警惕	no
人生如戏，如今场景已经布置好了，主角却已不在了	no
火大~火大~奇葩一枚。自己态度不好，还需要别人对你态度好吗？	no
王弼注：“阳气始剥尽至来复，时凡七日。	no
不刮风不下雨运动会为什么要延期，狗逼学校收钱怎么不延期	no
血糖低导致体质下降，体重也直速的下降	no
我原本计划好好的调时差贱洋又他妈来把我弄醒催我起床吃东西然后我吃完他就呼呼大睡了	no
我做过最疯狂的事就是勇敢和你在一起	no
跟我说句话跟我说句话跟我说句话能死吗	no
下雨打不到车挤不上公交提N多东西边走边掉妈蛋都去死	no
我没救了，纸媒老大，自打进门起就一直无视他，一直无视，一直无视，跟我说话也爱理不理，今天才知道他是老大，他是老大，他是老大	no
此刻让我最抓狂的事是有人在你身边吃东西吃的那个吧唧吧唧吧唧吧唧吧唧吧唧吧唧吧唧吧唧吧唧吧唧吧唧吧唧吧唧吧唧吧唧啊啊啊啊啊啊啊啊啊啊啊啊啊啊啊啊受不了了想揍人��✊✊✊抓狂的要死这种声音真心的听着难受，抓狂，想扁人	no
和真爱在一起各种搞怪，怎么舒服怎么来!	no
看你躺在怀里，不由想起你刚来我身边时的场景，未满两个月的你巴掌大的你好小好小，第一次养小奶狗什么都不懂，带着你去宠物店让你在地上走着一边叫着你怕你跑丢一边跟着你怕你有事，就那样跟了你一路笑了一路就感觉真的好搞笑，走哪都特别吸引目光，到宠物店了才知道你太小不能出门…有你真好	no
晋陶潜《杂诗》之三：“严霜结野草，枯悴未遽央。	no
记得小时候，爸妈总是在八九点钟，电视剧还没看完的时候，就催促我们去准备上床睡觉，然后小时候的我们，因为害怕还不能违抗父母，哪怕心里一百万个不愿意也会乖乖上床，把眼睛闭上。这一觉啊，没有噩梦，没有思念的人，没有被眼泪弄湿的枕头，可是，那样的日子，再也回不去了。	no
傻逼啊，我是惯着你，还是直接呼你脸啊	no
想剪短发又想留长发，女人真是个矛盾的生物体��	no
嗅出了一丝东的寒意所以童鞋一定要把自己弄得暖和一点LoveYou！MH	no
这其中，以巴巴多斯进入发达国家行列的意义最为重大，因为它成为拉丁美洲第一个发达国家，也是第一个以黑人为主体的发达国家。	no
这课上的要疯了wuliaohehe	no
我今天才知道，原来我家是卖牙膏的	no
困得蒙瞪的，一下子就气清醒了，what'sthefuck!	no
尝新，我说的是杯子。设计感和质感都超级好。贵，但有它的价值。	no
SR型具有出色的错误消除能力，可以直接安装在飞机地板上，简化了组装工作。	no
一个月内剪两次发！只因上次的垃圾所谓总监把发剪得太难睇了！	no
我是69年的，69年的，69年的。说三遍。领导们又把我师弟说成师兄，把我搞成青年委员……说好的青年委员起码70后好不好……长的年轻居然有这样的劣势！无语……	no
每天做着低情商的事儿……真想给自己抽两个耳光	no
快告诉我什么方法能尽快去除油漆味，刚装修の店太难闻了，待久了，我头晕	no
这个学期已经连续无数次睡午觉被舍友熬中药的味儿熏到自然醒虽说我和你形同陌路但我心底还是希望你赶紧治好你病妈的老子真的要被熏死了！一天三次！一天！三次！	no
大家为什么都喜欢星期四呢？真烦人	no
再被不相干的人或事影响心情我就去死！	no
真好，害怕一个人上厕所的时候，恰巧有一个人还没睡，然后就可以很放心的去上厕所了！让我乐一下……不要打我，这是我的真心话！	no
我蠢我蠢我蠢我蠢！！！放着好好的壹级公司不要偏偏要贰级，请给我一把刀，真想分分钟切腹算了	no
现在真是一个看脸的时代，中国人民银行也豁出去了：新版人民币，连毛爷爷都打了水光，双下巴没有了，皮肤更加细腻有光泽了	no
天了噜，你在逗我吗珠海第三次尝试入冬失败供什么暖，制冷还差不多	no
【吃糖要快快的吃】对于糖果来说，则吃起来与苹果恰恰相反，这是因为人的口腔里有一种乳酸杆菌！能使糖发酵产生酸、粮在嘴里的时间越长。产生的乳酸越多！对牙越不利：所以……吃糖一定要快……	no
艾蒙特（伊万·麦格雷戈饰）国王忠诚的侍卫队长。	no
最近我的牙不知道怎么了为什么会这么疼呢?	no
菲律宾总统阿基诺在和王毅握手时，另一只手插在兜里。弹丸之地啊，等我们在强大些，放心还会找回来的	no
过了睡觉的点就睡不着了这么长时间以来第一次失眠！	no
日常失眠打卡。可怜我明天4点就得去实训……	no
冷得睡不着感觉被子里漏风南方人都是怎么活过来的	no
为毛我刷个微博一直闪退啊啊啊啊啊啊	no
浔阳柴桑（今江西九江西南）人。	no
今晚，来朋友店喝茶闲聊，跟一帮小年轻在一起，哥顿时也年轻了不少。。。	no
太诡异了前一次夜里下雨窗户没关早上醒来还想着地板应该是湿了结果发现窗户已经关好。昨天睡前想要开驱蚊器发现开了今早醒来伸手准备关可驱蚊器早就关了	no
蒸发器的特点目前常用的间壁传热式蒸发器，按溶液在蒸发器中停留的情况，大致可分为循环型和单程型两大类。	no
当货物贵到极点时，要及时卖出，视同粪土；	no
4.一般从事CAD工作行业的大多为绘图员，全国月平均工资3000——3500左右，当然也少不了自己对专业知识的掌握和了解。	no
